SO ./textures/south.xpm
WE ./textures/west.xpm
NO ./textures/north.xpm
EA ./textures/east.xpm

F 20,20,20
C 200,200,200

111111111
11001111111
100000W11
111111111