SO ./textures/south.xpm
WE ./textures/west.xpm
NO ./textures/north.xpm
EA ./textures/east.xpm

F 20,20,20
C 200,200,200

11111111111111111111111111111111111111111111111111111111
100000000000000000000000000001100000000000000000000000111
1000001100000001111110000000000000000000000000000000000011
1000001100110000000010000000011000000000001111100010000001
1000001111110001111110000000011000000000001   100011110001
1000000000110001000000000000011000000000001   100010010001
1000000000110001111110000000011000000000001   100010010001
1000000000000000000000000000011000000111111111100010010001
1000001111111111111110000000011000000000000000000000000001
1000000000000000000000000000000000000000000000010000000001
1000000000000000000000000000000000000000000111111000000001
10000000001111110000000000000110000000000001    1000000001
10000000001    10000000000000110000000N00001    1000000001
10000000001    10000000000000110000000000001    1000000001
10000000001    1000000000000011000000000000111111000000001
10000000001    1100000000000000000000000000000000000111001
1000000000111111111111100000011000000000000000000000001001
1000000000000000000001100000000000001111110000010000001001
1000000000000000000001100000011000000011000000010000001001
1000000000000000000000000000011000001111110000010011111001
1000000000000000000001110000011000000011000000010010000001
1000000111111100000001110000011000000011000000011110001111
10000001111111000000000000000110000111111110000000000111
100000000001110000000000000001100000001100000000111111
100000000000000000000000000001100000001100000000011
10000000000000000000000000000110000000000000000001
11111111111111111111111111111111111111111111111111