SO ./textures/south.xpm
WE ./textures/west.xpm
NO ./textures/north.xpm
EA ./textures/east.xpm

F 20,20,20
C 200,200,200

1111111111111111111111111111111111111111
1000000000000000000000000000000000000001
1000000001100000000110000000011000000001
1000000001100000000110000000011000000001
1001000001100000000110000000011000000001
1001110101100000000110000000011000000001
1000010101100000000110000000011000000001
1000010100000000000000000000000000000001
1000000000000000000000000000000000000001
1000000000000000000000000000000000000001
1000000000000000000000000000000000000001
1000000000000000111110000000000000000001
1000000000000000000000000000000000000001
1000000000000000000000000000000000000001
1000000000000000000000000000000000000001
1000000000000000000000000000000000000001
1000000000000000000000000000000000000001
1000000000000000000000000000000000000001
1000000000000000000000000000000000000001
1000000000000000000000000000000000000001
1000000000000000000000000000000000000001
1000000000000000000000000000000000000001
1000000000000000000000000000000000000001
1000000000000000000000000000000000000001
1000000000000000000000000000000000000001
1000000000000000000000000000000000000001
1000000000000000000000000000000000000001
1000000000000000000000000000000000000001
1000000000000000000000000000000000000001
1000000000000000000000000000000000000001
1000000000000000111110000000000000000001
1000000000000000000000000000000000000001
1000000000000000000000000000001S00000001
1000000000000000000000000000000000000001
1111111111111111111111111111111111111111