NO ./textures/n.xpm
SO ./textures/s.xpm
WE ./textures/e.xpm
EA ./textures/w.xpm
F 34,139,34
C 135,20,235

111111
100001
100N00
111111