NO ./textures/n.xpm

SO ./textures/s.xpm

WE ./textures/e.xpm

EA ./textures/w.xpm

F   34,139,34

C   135,20,235

          111111
1111111111100001
10000000001000N1
          111111

so this char **:

        1111111111111111111111111
        1000000000110000000000001
        1011000001110000000000001
        1001000000000000000000001
111111111011000001110000000000001
100000000011000001110111111111111
11110111111111011100000010001
11110111111111011101010010001
11000000110101011100000010001
10000000000000001100000010001
10000000000000001101010010001
11000001110101011111011110N0111
11110111 1110101 101111010001
11111111 1111111 111111111111

will become this int **:

000000001111111111111111111111111
000000001000000000110000000000001
000000001011000001110000000000001
000000001001000000000000000000001
111111111011000001110000000000001
100000000011000001110111111111111
111101111111110111000000100010000
111101111111110111010100100010000
110000001101010111000000100010000
100000000000000011000000100010000
100000000000000011010100100010000
11000001110101011111011110N011100
111101110111010101011110100010000
111111110111111101111111111110000

XXXXXXXXXXXXXXXXXXXXXXXXXXXXXXXXXX
X       1111111111111111111111111X
X       1000000000110000000000001X
X       1011000001110000000000001X
X       1001000000000000000000001X
111111111011000001110000000000001X
100000000011000001110111111111111X
11110111111111011100000010001X
11110111111111011101010010001X
11000000110101011100000010001X
10000000000000001100000010001X
10000000000000001101010010001X
11000001110101011111011110N0111X
11110111 1110101 101111010001X
11111111 1111111 111111111111X
XXXXXXXXXXXXXXXXXXXXXXXXXXXXXX

XXXXXXXXXXXXXXXXXXXXXXXXXXXXXXXXXXX
XXXXXXXXX1111111111111111111111111X
XXXXXXXXX1000000000110000000000001X
XXXXXXXXX1011000001110000000000001X
XXXXXXXXX1001000000000000000000001X
X111111111011000001110000000000001X
X100000000011000001110111111111111X
11110111111111011100000010001X
11110111111111011101010010001X
11000000110101011100000010001X
10000000000000001100000010001X
10000000000000001101010010001X
11000001110101011111011110N0111X
11110111X1110101X101111010001X
11111111X1111111X111111111111X

X11111111111111111111111111
X10001111111111111111110001
X10001111111111111100010001
11001001XXXXXXXXX100010001
10001001111111111100010001
10001000000000000000010001
10001000000000000000010001
10001111111111111111110001
1111111111XX11XX111111111   

11111111111111111111111111
10001111111111111111110001
10001111111111111100010001
10001000000000000100010001
10001001111111111100010001
10001000000000000000010001
100010000000000XXXX0010001
10001111111111111111110001
11111111111111111111111111
00000000000000000000000000

or this 

11111111111111111111111111XXXXXX
10001111111111111111110001XXXXXXXXXXX
10001111111111111100010001XX
10001000000000000100010001XXXXXX
10001001111111111100010001X
XXXXXXXXXXXXXX
10001000000000000000010001X
10001000000000000000010001XX
10001111111111111111110001X
11111111111111111111111111XXXXXXXXXX
00000000000000000000000000XXX

is not valid. because remember that:
"Except for the map, each type of information from an element can be separated
by one or more spaces.
Except for the map content, each type of element can be separated by one or
more empty lines."