NO ./textures/n.xpm
SO ./textures/s.xpm
WE ./textures/e.xpm
EA ./textures/w.xpm
F 34,139,34
C 135,20,235

1111111
11000001
11000N01
1111111
