SO ./textures/south.xpm
WE ./textures/west.xpm
NO ./textures/north.xpm
EA ./textures/east.xpm

F 20,20,20
C 200,200,200


1111111111
1000000001
1000000001
100000W000
1001000001
1001110101
1000010101
1000010101
1000000001
1111111111